***
| |
***

* *   ***   ***   ***
| |   |     | |     |
***   ***   * *   ***

* *   ***   ***   * *
|     |       |     |
***   * *   * *   ***

* *   * *   ***   * *
      |             |
***   * *   * *   * *

* *
   
* *
